                                             
@################ ####### ########### # #  #$
  #     #         #   # ####     ## # ###### 
###   ### ##  #########   ###### ## # #  # # 
#    ## #  ## # # # # #   ## #   #  # # ## # 
#   ##  #   # #     ####  ## ## ########## # 
#   #   #  #########      #   #     #   #  # 
#####   ####    #  ############ ##### ###  # 
              #####                          