#        ##
### #### ##
# #    # ##
# #### # ##
#      #   
##########$