         #
  @#######  #      
         #  #
         #  #
      #######
   ####
      #
  #####$#
  #
  #
 #############
         #
         #####
  ########   #
     #       #
     #       #
