  @
  #
  #    #
  #####
############
  #   #   #
  #
  #   #   #
  #   #   $
