##############    ###
     #   #    #  #    # #
     ######    # #     # ##
     #            $    # #
     #   #     ######### #
     #   #             # #
     #                 # #
     #                 # #   
     #            #    # #
     #        ########## #
################       # #
     #         @       # #
     #   #     #   #       # #
     #   #     #####       # #
     #   #         #       # #
     ############    #         #
     #             ###########
     #                  #
