##############    ##@
#   #    ####     # #
######    # #     # #
#   #     ######### #
#   #             # #
#                 # #
#                 # #
#        ##       # #
#        ##       # #
#        ########## #
###############  # #
#         #       # #
#     #   #       # #
#     #####       # #
#      #  #       # #
########  #########         #
#             ###########
$                  #
