 #@###
 # ###
 # ###
 #   #
 ###$#
