 #@### #############
 # # # ########### #
 #  #   #######  ###
 ## ####  ####
    ### ############
 ## ### #####   ####
 #  ################
 #$#################
