 ###########
 $   #   # @
 # # # # # #
 # #   # # #
 # ##### # #
 #   #   # #
 ### ##### #
 # #   #   #
 # ### # # #
 #       # #
 ###########
