# $#  #
#   ####
###  # #
 # @## #
 #    ##
## #### 
 ### ###
