                
      #####     
     ##   ##    
  ############  
    #      #    
    #      #    
  ############$ 
                
