    ##########
          #
          #########################
          #              #
       ########          #
       #                 #
       #
       ##                              #
 #########################################
       #       #             ###########
########       #             #         #
#              ###############         #
#                                      #
#                                      #
########################               #$
                       #
                       #
                       #
                       ########
