######## #### #
# ######### ###
###############
### ## ###### #
### ##### #####
# ##### #### ##
#### ##########
# ##### ### ###
## ### ######$#
