
           ###         #
             #   #############
      ###    #####       #  #
        #       #           #
        #       #      #    #
        ########@############
                #         #
                #       ####
                #         #
        #########         #################
        #                                 #
        #           ####              $
    ########        #                 #
           #        #                 #
           ############################
                            #
                            #
                            #
                            #
                            ###########################