
            #
##   ######## ###
###### #      # #
##   #######  ###
@#         #### 
##   ######   #                  #
###### #      ###########        #
##   ##########    #    #        #
##        #        #    #        #####
##        #################      #   #
###########               #      #####    
                          #      #
                          #      # 
                      $###########